NO ./pics/purplestone.xpm
SO ./pics/darkw.xpm
WE ./pics/wood.xpm
EA ./pics/colorstone.xpm

F 225,225,0
C 225,0,255

  11111111
  10000001111111
  10100000000001
 110000001111111
1000W0011111
110000000001
110000111111
1111111